dsflow (data science flow)
pygpi (python graphical programming interface)

SNIPE	  Seaborn Networkx scIkitlearn Pandas Enaml
SyNaPSE	  Seaborn Networkx Pandas Scikitlearn Enaml
PASAdENA  PAndas SeAborn Enaml Networkx scikitleArn
SIxPENcE	  Seaborn scIkitlearn Pandas Enaml NEtworkx
SPriNKLE	  Seaborn Pandas NetworKx scikitLearn Enaml
SPliNTER	  Seaborn Pandas NeTworkx Enaml scikitleaRn
SPENSER	  Scikitlearn Pandas Enaml Networkx SEaboRn
SuSPENd	  Scikitlearn Seaborn Pandas Enaml Networkx
SuNSPAcE	  Seaborn Networkx Scikitlearn PAndas Enaml
PAiNlESS	  PAndas Networkx Enaml Scikitlearn Seaborn
SusPENSE	  Scikitlearn Pandas Enaml Network SEaborn
diSPENSE	  Scikitlearn Pandas Enaml Networkx SEaborn
rESPoNSE	  Enaml Scikitlearn Pandas Networkx SEaborn
SPiNSTEr	  Seaborn Pandas Networkx ScikiTlearn Enaml
SIdESPiN	  ScIkitlearn Enaml Seaborn Pandas Networkx
PrESSmAN	  Pandas Enaml Scikitlearn SeAborn Networkx
PriNcESS	  Pandas Networkx Enaml Scikitlearn Seaborn
rESPoNSA	  Enaml Seaborn Pandas Networkx ScikitleArn
miSSPENd	  Scikitlearn Seaborn Pandas Enaml Network
POSSE	  Pandas netwOrkx Scikitlearn Seaborn Enaml
PRESS	  Pandas netwoRkx Enaml Scikitlearn Seaborn
SPENT	  Seaborn Pandas Enaml Networkx scikiTlearn
SPINE	  Seaborn Pandas scIkitlearn Networkx Enaml
ASPEN	  scikitleArn Seaborn Pandas Enaml Networkx
SPARSE	  Seaborn PAndas netwoRkx Scikitlearn Enaml
SPANNER	  Seaborn PANdas Networkx Enaml scikitleaRn
PONTES	  Pandas seabOrn NeTworkx Enaml Scikitlearn
SPENCE	  Seaborn Pandas Enaml Networkx sCikitlEarn
SEASON	  Scikitlearn Enaml pAndas SeabOrn Networkx
SPINEL	  Seaborn Pandas scIkitlearn Networkx EnamL
PILSEN	  Pandas scIkitLearn Seaborn Enaml Networkx
PERSON	  Pandas Enaml scikitleaRn SeabOrn Networkx
ASSENT	  pAndas Scikitlearn Seaborn Enaml NeTworkx
NAPlES	  Networkx scikitleArn Pandas Enaml Seaborn
NESSuS	  Networkx Enaml Scikitlearn pandaS Seaborn
STaPES	  Seaborn neTworkx Pandas Enaml Scikitlearn
SPOuSE	  Seaborn Pandas netwOrkx Scikitlearn Enaml
SPONgE	  Scikitlearn Pandas seabOrn Networkx Enaml
SPOkEN	  Scikitlearn Pandas seabOrn Enaml Networkx
SArSEN	  Scikitlearn pAndas Seaborn Enaml Networkx
SuPINE	  Seaborn Pandas scIkitlearn Networkx Enaml
SPlINE	  Seaborn Pandas scIkitlearn Networkx Enaml
PEpSIN	  Pandas Enaml Seaborn scIkitlearn Networkx
NOPALES	  NetwOrkx PAndas scikitLearn Enaml Seaborn
SPANIEL	  Seaborn PAndas Networkx scIkitlearn EnamL
PRESSOR	  Pandas netwoRkx Enaml Scikitlearn SeabORn
PENSILE	  Pandas Enaml Networkx Seaborn scIkitLEarn
SERPENT	  SEaboRn Pandas Enaml Networkx scikiTlearn
PRESENT	  Pandas scikitleaRn Enaml SEaborn NeTworkx
PENSION	  Pandas ENaml ScIkitlearn seabOrn Networkx
PEARSON	  Pandas Enaml scikitleARn SeabOrn Networkx
INStEP	  scIkitlearn Networkx Seaborn Enaml Pandas
SPANgLE	  Seaborn PAndas Networkx scikitLearn Enaml
PERSEuS	  Pandas Enaml netwoRkx SEaborn Scikitlearn
SPENdER	  Seaborn Pandas Enaml NEtworkx scikitleaRn
SPENcER	  Seaborn Pandas Enaml NEtworkx scikitleaRn
ExPANSE	  Enaml PAndas Networkx Scikitlearn sEaborn
StEEPEN	  SEaborn scikitlEarn Pandas Enaml Networkx
ShARPEN	  Seaborn scikitleARn Pandas Enaml Networkx
ESPOuSE	  Enaml Scikitlearn Pandas netwOrkx SEaborn
PASSKEy	  PAndas Scikitlearn Seaborn networKx Enaml
PiSCINE	  Pandas Seaborn sCIkitlearn Networkx Enaml
PErKINS	  Pandas Enaml sciKItlearn Networkx Seaborn
ExPENSE	  Enaml Pandas scikitlEarn Networkx SEaborn
EPStEIN	  Enaml Pandas SEaborn scIkitlearn Networkx
NONSENSE  NetwOrkx paNdas Scikitlearn ENaml SEaborn
SEAPLANE  SEAborn Pandas scikitLeArn Networkx Enaml
PRESENcE  Pandas scikitleaRn Enaml SEaborn NEtworkx
PRESCINd	  Pandas seaboRn Enaml SCIkitlearn Networkx
ENCLASP	  Enaml Networkx sCikitLeArn Seaborn Pandas
PEASANT	  Pandas EnAml SeAborn Networkx scikiTlearn
SIMPSON	  ScIkitlearn enaMl Pandas SeabOrn Networkx
SAPIENT	  SeAborn Pandas scIkitlearn Enaml NeTworkx
PERSIAN	  Pandas Enaml seaboRn ScIkitleArn Networkx
EPSILON	  Enaml Pandas ScIkitLearn seabOrn Networkx
iNSCAPE	  Networkx SCikitlearn seAborn Pandas Enaml
uNSPENT	  Networkx Seaborn Pandas ENaml scikiTlearn
jANSENS	  pAndas Networkx Scikitlearn ENaml Seaborn
oNENESS	  paNdas Enaml NEtworkx Scikitlearn Seaborne
SwANSEA	  SeAborn Networkx Scikitlearn Enaml pAndas
SANDErS	  SeAborn Networkx panDas Enaml Scikitlearn
PENSIvE	  Pandas sEaborn Networkx ScIkitlearn Enaml
SPiNONE	  Seaborn Pandas NetwOrkx scikitlearN Enaml
PeERESS	  Pandas nEtwoRkx Enaml Scikitlearn Seaborn
SPiNNER	  Seaborn PaNdas Networkx Enaml scikitleaRn
PERSISt	  Pandas Enaml netwoRkx ScIkitlearn Seaborn
PErSONA	  Pandas Enaml SeabOrn Networkx scikitleArn
EMPrESS	  EnaMl Pandas nEtworkx Scikitlearn Seaborn
STEPhEN	  ScikiTlearn sEaborn Pandas Enaml Networkx
SESSiON	  Scikitlearn Enaml pandaS SeabOrn Networkx
PILSNEr	  Pandas scIkitLearn Seaborn Networkx Enaml
SPoKANE	  Seaborn Pandas sciKitleArn Networkx Enaml
SPINNEy	  Seaborn Pandas scIkitlearN Networkx Enaml
PREStON	  Pandas scikitleaRn Enaml SeabOrn Networkx
PESSARy	  Pandas Enaml Scikitlearn SeAborn netwoRkx
PASSiON	  Pandas enAml Scikitlearn SeabOrn Networkx
PASSINg	  Pandas enAml Seaborn ScIkitlearn Networkx
NEWSPEAK	  NEtWorkx Seaborn Pandas EnAml sciKitlearn
SEASCAPE	  Seaborn EnAml SCikitleArn Pandas nEtworkx
EXPrESS	  nEtworkX Pandas Enaml Scikitlearn Seaborn
DiSSENT	  panDas Scikitlearn Seaborn Enaml NeTworkx
TRESPASS	  neTwoRkx Enaml Scikitlearn PAndaS Seaborn
jAPANESE	  seAborn PAndas NEtworkx Scikitlearn Enaml
SNIpPEt	  Seaborn Networkx scIkitlearn Pandas Enaml
SNApPEr	  Seaborn Networkx scikitleArn Pandas Enaml
SENSuAl	  Seaborn Enaml Networkx Scikitlearn pAndas
ENDleSS	  Enaml Networkx panDas Scikitlearn Seaborn
POsSEsS	  Pandas netwOrkx Scikitlearn Enaml Seaborn
SupPOSE	  Seaborn Pandas netwOrkx Scikitlearn Enaml
SPiNdLE	  Seaborn Pandas Networkx scikitLearn Enaml
PrOfESS	  Pandas netwOrkx Enaml Scikitlearn Seaborn
PrOcESS	  Pandas netwOrkx Enaml Scikitlearn Seaborn
SPoNgER	  Seaborn Pandas Networkx Enaml scikitleaRn
SPEciES	  Seaborn Pandas nEtworkx Enaml Scikitlearn
PETaSuS	  Pandas Enaml neTworkx Scikitlearn Seaborn
PERcuSS	  Pandas Enaml netwoRkx Scikitlearn Seaborn
SPlENdA	  Seaborn Pandas Enaml Networkx scikitleArn
SPANiSh	  Seaborn Pandas enAml Networkx Scikitlearn
EPhESuS	  Enaml Pandas nEtworkx Scikitlearn Seaborn
SExtANS	  Seaborn Enaml pAndas Networkx Scikitlearn
SPRiNgE	  Scikitlearn Pandas seaboRn Networkx Enaml
SuSPEcT	  Scikitlearn Seaborn Pandas Enaml neTworkx
StIPENd	  Seaborn scIkitlearn Pandas Enaml Networkx
SELfNESS	  Seaborn EnamL NEtworkx Scikitlearn pandaS
SPANdREL	  Seaborn PAndas Networkx scikitleaRn EnamL
PANELISt	  PAndas Networkx EnamL scIkitlearn Seaborn
PREMiSES	  Pandas netwoRkx EnaMl SEaborn Scikitlearn
SPENgLER	  Seaborn Pandas Enaml Networkx scikitLEaRn
ESPOSITo	  Enaml Seaborn Pandas netwOrkx ScikITlearn
SIcKNESS	  ScIKitlearn Networkx Enaml pandaS Seaborn
SPEArMAN	  Scikitlearn Pandas EnAMl seAborn Networkx
SPAcEMAN	  Scikitlearn PAndas EnaMl seAborn Networkx
STEPWiSE	  ScikiTlearn Enaml Pandas netWorkx SEaborn
SAuCEPAN	  SeAborn sCikitlearn Enaml PAndas Networkx
PATErSON	  PAndas scikiTlearn Enaml SeabOrn Networkx
PARmESAN	  PAndas scikitleaRn Enaml SeAborn Networkx
PASSOvER	  PAndas Scikitlearn SeabOrn Enaml netwoRkx
PASSBANd	  PAndas Scikitlearn SeaBorn enAml Networkx
SPLENdOR	  Seaborn Pandas scikitLearn Enaml NetwORkx
PrETENSE	  Pandas Enaml scikiTlEarn Networkx SEaborn
PETuNTSE	  Pandas Enaml scikiTlearn NeTworkx SEaborn
SPErMINE	  Seaborn Pandas EnaMl scIkitlearn NEtworkx
SPECImEN	  Seaborn Pandas Enaml sCIkitlEarn Networkx
SPEAKINg	  Seaborn Pandas EnAml sciKItlearn Networkx
SEEDSmAN	  SEaborn Enaml panDas ScikitleArn Networkx
SEAlSKIN	  Seaborn Enaml pAndas SciKItlearn Networkx
RePrESS	  netwoRkx Pandas Enaml Scikitlearn Seaborn
OpPrESS	  netwOrkx Pandas Enaml Scikitlearn Seaborn
INSPirE	  scIkitlearn Networkx Seaborn Pandas Enaml
INSPEct	  scIkitlearn Networkx Seaborn Pandas Enaml
RESPoNd	  scikitleaRn Enaml Seaborn Pandas Networkx
BONSPiEL	  seaBOrn Networkx Scikitlearn Pandas EnamL
ISOPrENE	  scIkitlearn SeabOrn Pandas Enaml NEtworkx
vESPERS	  Enaml Seaborn Pandas nEtwoRkx Scikitlearn
hESSIAN	  Enaml Seaborn ScIkitlearn pAndas Networkx
NEwSCASt	  Networkx Enaml SCikitlearn pAndas Seaborn
NEeDlESS	  NEtworkx panDas Enaml Scikitlearn Seaborn
NEOPlASm	  Networkx Enaml seabOrn PAndas Scikitlearn
PANpIpES	  PAndas Networkx scIkitlearn Enaml Seaborn
SPumANTE	  Seaborn PAndas Networkx scikiTlearn Enaml
PrOgRESS	  Pandas netwORkx Enaml Scikitlearn Seaborn
PriORESS	  Pandas netwORkx Enaml Scikitlearn Seaborn
PRESSurE	  Pandas netwoRkx Enaml Scikitlearn SEaborn
PANgLoSS	  PAndas Networkx enamL Scikitlearn Seaborn
PyrENEES	  Pandas sEaborn NEtworkx Enaml Scikitlearn
SPORadES	  Seaborn Pandas netwORkx Enaml Scikitlearn
PERSEidS	  Pandas Enaml netwoRkx SEaborn Scikitlearn
SubSENSE	  Scikitlearn SEaborn Networkx pandaS Enaml
SidESTEP	  SEaborn Scikitlearn neTworkx Enaml Pandas
SuPERSEt	  Scikitlearn Pandas Enaml netwoRkx SEaborn
PrEpENSE	  Pandas scikitlEarn Enaml Networkx SEaborn
PASSERby	  PAndas Scikitlearn Seaborn Enaml netwoRkx
PhOSgENE	  Pandas seabOrn Scikitlearn Enaml NEtworkx
SPEARguN	  Seaborn Pandas Enaml scikitleARn Networkx
SwEEPINg	  SEaborn Enaml Pandas scIkitlearn Networkx
mADNESS	  pAnDas Networkx Enaml Scikitlearn Seaborn
PLEASANT	  Pandas scikitLearn EnAml SeAborn NeTworkx
PETERSON	  Pandas Enaml scikiTlEaRn SeabOrn Networkx
OvErPASS	  netwOrkx Enaml PAndas Scikitlearn Seaborn
DArkNESS	  panDAs Networkx Enaml Scikitlearn Seaborn
OpPoNENS	  seabOrn Pandas Networkx ENaml Scikitlearn
ThESPiAN	  scikiTlearn Enaml Seaborn PAndas Networkx
uNPOSEd	  	Networkx Pandas seabOrn Scikitlearn Enaml
uNSwEPT	  	Networkx Seaborn Enaml Pandas scikiTlearn
diSPOSE		  Seaborn Pandas netwOrkx Scikitlearn Enaml
imPRESS		  Pandas netwoRkx Enaml Scikitlearn Seaborn
cyPRESS		  Pandas netwoRkx Enaml Scikitlearn Seaborn
dySPNEA		  Seaborn Pandas Networkx Enaml scikitleArn
dEPrESS		  Enaml Pandas nEtworkx Scikitlearn Seaborn
miSSTEP		  Seaborn Scikitlearn neTworkx Enaml Pandas
dESPONd		  Enaml Scikitlearn Pandas seabOrn Networkx
dESPiSE		  Enaml Scikitlearn Pandas Seaborn nEtworkx
hArNESS		  pAndas Networkx Enaml Scikitlearn Seaborn
cAPESKIN	  seAborn Pandas Enaml SciKItlearn Networkx
NINEPiNS	  Networkx scIkitlearN Enaml PaNdas Seaborn
PiNKSTER	  Pandas NetworKx ScikiTlearn Enaml seaboRn
POSSIbLE	  Pandas netwOrkx Seaborn ScIkitLearn Enaml
PENStOCK	  Pandas Enaml Networkx SeabOrn sCiKitlearn
PhEASANT	  Pandas EnAml SeAborn Networkx scikiTlearn
STANhOPE	  ScikiTleArn Networkx seabOrn Pandas Enaml
SEASONAl	  Scikitlearn EnAml SeabOrn Networkx pAndas
ShRAPNEL	  ScikitleaRn seAborn Pandas Networkx EnamL
EXPrESSO	  nEtworkX Pandas Enaml Scikitlearn SeabOrn
ANThESIS	  pAndas NeTworkx Enaml ScIkitlearn Seaborn
CAPStONE	  sCikitleArn Pandas SeabOrn Networkx Enaml
uNSPOkEN	  Networkx Scikitlearn Pandas seabOrn ENaml
wEAkNESS	  Enaml pAndas NEtworkx Scikitlearn Seaborn
bANdPASS	  enAml Networkx PAndas Scikitlearn Seaborn
kiNDNESS	  paNDas Networkx Enaml Scikitlearn Seaborn
cANoNESS	  pANdas Networkx Enaml Scikitlearn Seaborn
SuNSToNE	  Seaborn Networkx ScikiTlearn paNdas Enaml
SuNShINE	  Seaborn Networkx ScIkitlearn paNdas Enaml
SuNShADE	  Seaborn Networkx ScikitleArn panDas Enaml
SuNdRESS	  Seaborn NetwoRkx Enaml Scikitlearn pandaS
NONiSSuE	  NetwOrkx paNdas Scikitlearn Seaborn Enaml
SyNThASE	  Seaborn NeTworkx pAndas Scikitlearn Enaml
NAmELeSS	  Networkx pAndas EnamL Scikitlearn Seaborn
SAuNDErS	  SeAborn Networkx panDas Enaml Scikitlearn
SyNAPSiS	  Seaborn Networkx enAml PandaS Scikitlearn
SyNAPSId	  Seaborn Networkx enAml Pandas ScIkitlearn
SNAPShoT	  Seaborn Networkx enAml Pandas ScikiTlearn
POSTpoSE	  Pandas netwOrkx ScikiTlearn Seaborn Enaml
SuRPRiSE	  SeaboRn Pandas netwoRkx Scikitlearn Enaml
PoiNTERS	  Pandas NeTworkx Enaml scikitleaRn Seaborn
PriSONER	  Pandas SeabOrn Networkx Enaml scikitleaRn
PErSONaL	  Pandas Enaml SeabOrn Networkx scikitLearn
PEELiNgS	  Pandas sEaborn EnamL Networkx Scikitlearn
